8
-W------------------
-----------------TW-
-----W-----------WW-
---W--------------W-
--------------------
---------------W----
----------W---------
--------------------
--------------------
W------------------W
-----------W--------
--------X-W--W------
----------------W---
--------------------
-W------------------
-----B--------------
-----W---W----------
-----------------W--
-T----->------W-----
-W------------------