25
---W-W--W-----------
-->-----------------
------W---------W---
-<---------------<--
-----------------WX-
--------W-----------
-------^------W-----
W-----------W------W
---W----------------
---W----------------
-T>------W--W-------
----------------W---
--------T--------W--
--------------------
->--WW--------------
-----W-------^------
--------------------
----WB>-------------
--------------------
---W-W-^W-----------