19
--------------------
W-----------------TW
--------------------
W------------------W
-^--------------W---
---W----------W-----
----W---------------
--------------------
--------------------
-----W----------^---
---------W---W------
-----W--------W-----
------------------W-
----------W---W-----
---WX-W----------WT-
--W-W--------W--v---
-----WW---------B---
--------------------
----------------W---
--------------------
