5
--------------------
-WW------------WW---
-WB-------------W---
-WW-----------------
--------------------
--------------------
--WW-------WW-------
--W---------W-------
--------------------
--------------------
--------------------
--------------------
-----X------W-------
-----------WW-------
--------------------
--W-------------W---
--WW-----------WW---
--------------------
--------------------
--------------------