16
--------------------
----WW--------------
------W---------TW--
---W----------------
--<-------^-----T---
----------B---------
-W-----------v--W---
----------^W-----WW-
----W--v------------
----W--W------------
-----------<--------
WW-----------------W
--------W-----W-W---
-W--------W---------
----------W---------
-----W-W------------
--------------------
---W--------------W-
WX-----------------W
--------------------