12
WWWWWWWWWWWWWWWWWWWW
--------------------
--W-----------------
-W---------------W--
-----------W--------
------WW------------
-W------v-----------
--W---W-------------
W----W--v-W--------W
W-^-------------W-WW
W------<------->---W
----XWB-W-----------
--------------------
-W----<----<----T---
-----------WW---W---
-->-----WW---W------
---WWW-<---------W--
-W---------------W--
WT-W---W---W---W---W
WWWWWWWWWWWWWWWWWWWW