27
-------------W------
--------------------
------WW-W----------
-----W--------TW----
----------------<---
-W--^----W-----W----
W-------W-----W----W
-----------------W--
---W----------------
--------W-----------
---------B--<-------
------T---------W---
--------------------
W-----WW------WW--WW
---WW--------W------
-W----------------W-
-----------------WX-
-W---------------W--
--------W-----------
-------------W------