24
-W-----W------------
--------------------
---W-----W-T--W---W-
W-------<------->-X-
--------------------
-------------W------
---------W--W--W----
----W------->-WWB---
--------------------
--W----------W--W---
-------------W----W-
--------------------
-W------W---------T-
---W---^------------
----v---------------
----------<-----W---
W----------WW------W
------>-------->----
W-W----------------W
-W-----W------------