15
-------W------------
------------WW------
-W------------W-----
------->-->----T<---
------W----W--W--WW-
--------------W-----
----W----------v-W--
----------------W---
--------------------
------W-------------
--------------------
----------B---------
--------------------
---W-------W-----v--
--W----W-------W-v--
--------------------
--W-W-----W-WW--WWW-
-------W------------
--T-XW------------<-
------W-------------