7
--------------------
-WW-----------------
-WB--------->-----W-
-WW-----------------
--------------------
--------------------
--------------------
---W----------------
-------->---------W-
--------------------
--------------------
--------------------
W--------v--------WW
W-----------------XW
W-----------------WW
--------------------
---------W----------
--W-----------------
-------------W------
--------------------