30
->-<-v->-<-v->-v-<->
<-^-<-v->-^-v-<-^-<-
-^-v-<-^-v-^-v->-v-<
v-<->->-^->-v->-^Xv-
->-<-^-v->-^-<-v->-<
^-<->-v->T^-v-<->-^-
-v-^->-<-<-^-v-<-v->
v-^-<-v-^-v-<-^->-v-
-^-<-^->-<-v->-^-v-<
^-<->-v-^-<-v->-^-v-
->-^-<->-v-<-^->-<->
^->-v-^-<->->-v-^-v-
-^-v-<-v->-^-v-<->-<
>-^-v-<-^->-<->-<->-
->-<-v->-^-<->-v-^-<
v-^-<->B>-v->-^->-v-
-^-v->-<->-^-v-^-<->
^-<->-v-^T>-v->-^-v-
-<->-v-<->-v-<-v->-<
^-v-^-v-^-v-^-v-^-v-