28
------------WW--W-W-
------W-------W--WW-
--X-----W------W----
---T---------W-W-<--
-----W--W-----B--W--
-----------W--W-----
-W---------W---W----
---------------W-<--
--------------------
---->---------------
-----^------W---W---
----W------------W--
--W--------W--------
-------W--^---------
W----------W-------W
--------------W-----
-------------W------
---W----------------
-----T-------W------
------------WW--W-W-