6
-WW-----------------
-W----------------T-
------WW--------WW--
------W----------W--
--------------------
--------------------
--------------------
--------------------
--X-----------------
--------------------
--------------------
------WBW-----------
------WWW-----------
--------------------
-----------WW-------
------T-----W-------
--------------------
--------------------
----------W------W--
----------WW----WW--