21
---W----------W-----
---------W----W-W-W-
-----W--------------
-WW---T-W--------W--
------W----------W--
-W--------W---------
----------WW--------
---v-W--------------
----<------X-T------
-----------W--------
--------W-W---------
----W--------W--WW--
--W------W---W------
--W----------W------
--------W--W--------
---W--W--->---W-----
--------------------
---B-------W-----W--
-------------W---W--
---W----------W-----