10
--W-----------------
--------------------
--B---------------W-
----------W------WW-
-----------WX-------
-W----------W----W--
--W-----------------
------W-------W-----
W------------W----TW
--------------------
--------------------
-------W------------
------------W-------
---------------W----
-------WW-----------
---W----------------
--------------------
--T-----------------
-----------W--------
--W-----------------