26
W--WW--------------W
---W-------W--------
W-------vW-----W-B-W
---------------W----
--------v-----------
--------------------
------------X---W---
----v---------------
-------v----T----W--
--------->--W---->--
W--^------W--------W
---------W----------
--W-----W--W--------
------^-------------
--------W-----------
--------------W-W---
----------------W---
-----------W---^----
----------WT----Wv--
W--WW--------------W