13
--W---W---------W---
--------------------
-W-----W---W--------
-W----------BWT-----
------------W-------
W----W-------------W
-------------W------
-----------------W--
--W-----------------
-----W--------------
-----W-----W--W-----
WX---WWW---W-------W
-W--W-------W---W---
------------>----W--
--------------------
W-----W------------W
-----W----W---------
----------W-WT------
--------------------
--W---W---------W---