17
-----W--W-----------
--------------------
--->-----T-W--------
----W----------W----
W--B---------------W
--------------------
-W--X----W-W----W---
-------W------W-----
--------------W-----
------------------W-
--------------------
------W----^--------
-W--------W----W----
--------W-----------
------W---W---------
-----W---W----------
--------W-------<---
-------W-W----------
-T------------W-----
-----W--W-----------