29
-W----------------W-
----------W--X----W-
----------------W-W-
----W----W--W----W--
W------W-W-v------Wv
--------------------
-----W-WW-----------
-------W----WW------
----------W-------W-
--W--W--W------W-W--
------W------^---B--
--------------------
-----------W--------
---T--------W-----T-
-W--W---------------
-W----------->-W-W--
W----WW-----W------v
--------WW---W------
--W-----W---W-------
-W----------------W-