20
-------W----------W-
--------W-W------W--
---W--WW---------W--
-------W--W------W--
--------------W-----
-v---------------W--
---B----------------
--------------------
-<-<-------<--------
------W---W---W-----
-W------------------
W---W-->-----------W
-----W-W-----W------
--X->---W--------WT-
-------------<--<---
W-------W----------W
------W--W---W--W---
---<----------<--<-<
-TW--------------->-
-------W----------W-