11
--W--W---WW----WW---
------W-----W---WW--
-----------WW-----W-
------W-----------X-
---W---W--------W---
-----WW------W----W-
------>----WWWW--^--
---WWW-------WWW----
--------------------
--T----W-W----T-----
--W-W---------------
-W------------------
----------W-------W-
------W------W------
--------------W-W---
---W-------WB---W---
----W----W--W-------
------------------W-
--W-W-----------WW--
--W--W---WW----WW---