4
--------------------
-WW---------W---WW--
-WB-------->-----W--
-WW--WWW--------WW--
-----W-W------------
-----W---X----------
------^-------------
-WW---------v-------
-W-----<-----W------
-WW---W-------------
--------------------
--------------------
-----------W-W------
-----------WWW------
--------------------
--------------------
--------------------
--------------------
--------------------
--------------------