14
-----------W----WW--
-----W-W---<--------
---T>-------W-------
--W-----------W-----
---------------W-W--
--------------------
----W------------X--
--------W--------W--
--------------------
--------------------
--------------------
--------------------
->---------------B--
--------------------
--------------------
--W--------------W--
----W----------WT---
--------------W-----
----<-------W-------
-----------W----WW--