22
--------------------
--W----WW-----------
-----------T-W-W----
-----------------<--
-----------W---W----
-----W-W------------
WW---------->B-----W
----W----W----------
--------------------
-----W-------WW-----
---------------WWW--
W---------W-W-v----W
--------W----<--X---
--------W-----W-----
-----WW------->-----
-W-W-----W----------
------W----------T--
----W------W--------
----------W----WW---
--------------------