23
-------W---W--------
----W------------X--
-------------W------
-------W---------W--
---WW------------B--
------------W-WW----
--------------------
-W---------W--------
---W--------W-------
----W---W-----------
------->-------W----
--------------------
--W--W-W--W--W---W--
---W-------------W--
-T---------------T--
--W-----------------
--------W-----------
----W-------------W-
-----------W--WW-W--
-------W---W--------