9
------------------W-
----X-----W----T--W-
W-----------W------W
W------------------W
-------------W---W--
--W-----------------
--------------------
-----------------W--
--------------------
--------------------
----------B---------
--------------------
------T---W---------
---W----------------
W----------->-----vW
WW-----------W---W-W
----W---------------
---W----------------
------------------W-
--------------------