18
-----W--WWW-W-WW----
--<-----<-<<---<<--<
-WT-----W-W-------W-
--X-----------------
-------------->-----
-W^----<-----------W
W---------W----W---W
-----------W----W---
W^---------W-------W
-----W-W-W---WW-----
--------------------
W-----------<---<--W
------------W-----W-
-----------W--------
------<-------------
-W------------------
---------<------B-<-
--------------------
W-----W--TW--------W
-----W-WWW-W-WW-----